


 , , , , , , , , , , , , , , , , , , ,0, , , , , , , , , , , , , , , , , , ,
 , , , , , , , , , , , , , , , , , , ,0, , , , , , , , , , , , , , , , , , ,
 , , , , , , , , , , , , , , , , , , ,0, , , , , , , , , , , , , , , , , , ,
 , , , , , , , , , , , , , , , , , , ,0, , , , , , , , , , , , , , , , , , ,
 , , , , , , , , , , , , , , , , , , ,0, , , , , , , , , , , , , ,e, , , , ,
 , , , , , , , , , , , , , , , , , , ,0, , , , , , , , , , , , , ,4, , , ,q,
 , , ,p, , , , , , , , , , , , , , , ,0, , , , , , , , , , , , , , , , ,G, ,
 , , , , , , , , , , , , ,d, , ,0, , ,0, , , , , , , , , ,0,0, , , , , ,0,0,
 , , , , , , , , , , , ,0,0, , , , , , , , , , ,0, , , , ,0,0,0,0,0,0,0,0,0,
 , ,0,0,0, , , , , , , , , , , , , , , , , , , , , , , , ,0,0,0,0,0,0,0,0,0,
 , , , , , , , , , , , , , , , , , , , , , ,0, , , , , , ,0,0,0,0,0,0,0,0,0,
 , , , , , , , , , , , , , , , , , , , , , , , , , , , , ,0,0,0,0,0,0,0,0,0,