


 , , , , , , , , , , , , , , , , , , ,0, , , , , , , , , , , , , , , , , , , , , , , , , , , , , , , , , , , , , , , , , , , , , , , , , , ,
 , , , , , , , , , , , , , , , , , , ,0, , , , , , , , , , , , , , , , , , , , , , , , , , , , , , , , , , , , , , , , , , , , , , , , , , ,
 , , , , , , , , , , , , , , , , , , ,0, , , , , , , , , , , , , , , , , , , , , , , , , , , , , , , , , , , , , , , , , , , , , , , , , , ,
 , , , , , , , , , , , , , , , , , , ,0, , , , , , , , , , , , , , , , , , , , , , , , , , , , , , , , , , , , , , , , , , , , , , , , , , ,
 , , , , , , , , , , , , , , , , , , ,0, , , , , , , , , , , , , ,e, , , , , , ,q, , , , , , , , , , , , , , , ,e, , , , , , , , , , , , , ,
 , , , , , , , , , , , , , , , , , , ,0, , , , , , , , , , , , , ,4, , , , , , , , , , , ,0,G, , , , , , , ,0,0,4,0,0, , , , , , , , , , , ,
 , , ,p, , , , , , , , , , , , , , , ,0, , , , , , , , , , , , , , , , ,G, , , , , , , , ,0,0,0,0, , , , , , , , , , , , , , , , , , , , , ,
 , , , , , , , , , , , , ,d, , ,0, , ,0, , , , , , , , , ,0,0, , , , , ,0,0, , , , , , , , , , , , , , , , , , , , , , , , ,0,s, ,s, ,s, ,0,
 , , , , , , , , , , , ,0,0, , , , , , , , , , ,0, , , , ,0,0,0,0,0,0,0,0,0, , , , , , , , , , , , , , , , , , , , , , , , , ,0,0,0,0,0,0, ,
 , ,0,0,0, , , , , , , , , , , , , , , , , , , , , , , , ,0,0,0,0,0,0,0,0,0, , , , , , , , , , , , , , , , , , , , , , , , , , , , , , , , ,
 , , , , , , , , , , , , , , , , , , , , , ,0, , , , , , ,0,0,0,0,0,0,0,0,0, , , , , , , , , , , , , , , , , , , , , , , , , , , , , , , , ,
 , , , , , , , , , , , , , , , , , , , , , , , , , , , , ,0,0,0,0,0,0,0,0,0, , , , , , , , , , , , , , , , , , , , , , , , , , , , , , , , ,