






 , , , , , , , , , , , , , , , , , , , , , , ,
 , , , , , , , , , , , , , , , , , , , ,0, , ,
 , , , , , , , , , , , , , , , , , , ,0,0, , ,
 , , ,p, , , , , , , , ,0, , , , , , , ,0, , ,
 , , , , , , , ,0, , ,d, ,0, ,s, , , , ,0, , ,
0,0,0,0,0,0,0,0,0,0,0,0,0,0,0,0,0,0,0,0,0,0,0,0
0,0,0,0,0,0,0,0,0,0,0,0,0,0,0,0,0,0,0,0,0,0,0,0
0,0,0,0,0,0,0,0,0,0,0,0,0,0,0,0,0,0,0,0,0,0,0,0