


 , , , , , , , , , , , , , , , , , , ,0, , , , , , , , , , , , , , , , , , ,
 , , , , , , , , , , , , , , , , , , ,0, , , , , , , , , , , , , , , , , , ,
 , , , , , , , , , , , , , , , , , , ,0, , , , , , , , , , , , , , , , , , ,
 , , , , , , , , , , , , , , , , , , ,0, , , , , , , , , , , , , , , , , , ,
 , , , , , , , , , , , , , , , , , , ,0, , , , , , , , , , , , , ,e, , , , ,
 , , , , , , , , , , , , , , , , , , ,0, , , , , , , , , ,p, , , ,4, , , ,q,
 , , , , , , , , , , , , , , , , , , ,0, , , , , , , , , , , , , , , , , , ,
 , , , , , , , , , , , , ,d, , ,0, , ,0, , , , , , , , , ,0,0, ,s, , , ,0,0,
 , , , , , , , , , , , ,0,0, , , , , , , , , , ,0, , , , ,0,0,0,0,0,0,0,0,0,
 , ,0,0,0, , , , , , , , , , , , , , , , , , , , , , , , ,0,0,0,0,0,0,0,0,0,
 , , , , , , , , , , , , , , , , , , , , , ,0, , , , , , ,0,0,0,0,0,0,0,0,0,
 , , , , , , , , , , , , , , , , , , , , , , , , , , , , ,0,0,0,0,0,0,0,0,0,