


 , , , , , , , , , , , , , , , , , , ,0, , , , , , , , , , , , , , , , , , ,
 , , , , , , , , , , , , , , , , , , ,0, , , , , , , , , , , , , , , , , , ,
 , , , , , , , , , , , , , , , , , , ,0, , , , , , , , , , , , , , , , , , ,
 , , , , , , , , , , , , , , , , , , ,0, , , , , , , , , , , , , , , , , , ,
 , , , , , , , , , , , , , , , , , , ,0, , , , , , , , , , , , , ,e, , , , ,
 , , , , , , , , , , , , , , , , , , ,0, , , , , , , , , , , , , ,4, , , ,q,
 , , , , , , , , , , , , , , , , , , ,0, , , , , , , , , , , , , , , , , , ,
 , , ,p, , , , , , , , , ,d, , ,0, , ,0, , , ,0, , , , , ,0,0, ,s, , , ,0,0,
 , , , , , , , , , , , ,0,0, , , , , , , , , , , , , , , ,0,0,0,0,0,0,0,0,0,
 , ,0,0,0, , , , , , , , , , , , , , , , ,0, , , , , , , ,0,0,0,0,0,0,0,0,0,
 , , , , , , , , , , , , , , , , , , , , , , , , , , , , ,0,0,0,0,0,0,0,0,0,
 , , , , , , , , , , , , , , , , , , , , , , , , , , , , ,0,0,0,0,0,0,0,0,0,